1,1,1,1,1,1,1,1,1,1,1,1,1,1,1
1,1,0,0,0,0,0,0,1,0,0,0,0,1,1
1,0,0,Se3,0,0,0,Se3,0,0,0,0,0,0,1
1,0,0,0,0,0,0,0,0,0,0,0,0,Se3,1
1,0,0,0,0,0,0,0,1,0,0,P,0,0,1
1,0,0,0,0,0,0,0,1,0,0,Se3,0,0,1
1,0,0,0,0,0,0,0,1,0,0,0,0,0,1
1,0,0,0,0,0,0,0,1,1,0,0,1,1,1
1,1,1,1,0,0,1,1,1,0,0,0,0,1,1
1,1,0,0,1,0,0,0,0,0,0,0,0,0,1
1,0,0,0,0,0,0,0,0,0,0,Se3,0,0,1
1,0,S,0,0,0,0,0,1,0,Se2,0,1,0,1
1,0,0,0,0,0,0,0,1,0,0,0,Se3,0,1
1,1,0,0,0,Se3,0,0,1,0,0,0,0,1,1
1,1,1,1,1,1,1,1,1,1,1,1,1,1,1