1,1,1,1,1,1,1,1,1,1,1,1,1,1,1
1,0,0,0,0,0,0,1,0,0,0,0,0,0,1
1,0,0,0,0,0,0,1,0,0,0,0,0,0,1
1,0,,0,0,0,0,Co,Co,Co,0,0,0,0,1
1,0,0,0,0,0,L,0,0,0,0,0,0,0,1
1,0,0,0,0,0,0,0,0,0,0,0,0,0,1
1,0,0,0,T,0,0,0,L,0,0,0,0,0,1
1,0,0,0,0,0,0,T,0,0,0,0,0,0,1
1,0,0,0,0,0,P,Sh3,0,0,0,Me,0,0,1
1,0,0,0,0,S,0,Sh25,0,0,0,0,0,0,1
1,0,0,,0,0,0,0,Sh3,0,0,0,0,0,1
1,0,0,0,0,0,0,0,0,,0,0,0,0,1
1,0,0,0,0,0,S,0,0,0,0,0,0,0,1
1,0,0,0,0,0,0,0,0,0,0,0,0,0,1
1,1,1,1,1,1,1,1,1,1,1,1,1,1,1